03,10,01,01,01,01,01,01,01,01,01,01,01,01,01,01,01,01,01,01,01,01,01,01,01,01,01,01,01,01,01,01
10,03,05,05,01,01,01,01,01,01,01,01,01,01,01,01,01,01,01,01,01,01,01,01,01,01,01,01,01,01,01,01
15,01,01,15,04,04,01,01,01,01,01,01,01,01,01,10,10,10,11,02,10,10,10,10,10,10,01,01,01,01,01,01
15,01,01,01,01,03,14,14,02,11,01,01,01,01,01,01,01,04,10,01,14,01,01,00,01,01,01,01,01,01,01,01
00,01,01,01,01,01,03,11,13,13,03,05,02,15,01,13,13,01,01,02,13,00,01,01,01,01,01,01,01,12,01,01
14,03,01,42,01,01,01,12,04,02,02,00,01,11,04,02,01,12,00,03,11,00,01,01,01,01,01,01,01,15,01,01
00,01,12,00,01,10,05,01,14,12,01,04,04,02,10,10,11,02,02,15,01,12,00,01,01,01,10,10,01,01,15,01
12,11,10,10,01,10,10,01,03,04,05,10,42,14,10,03,13,04,15,13,01,01,05,04,01,14,14,14,05,04,13,13
03,14,04,01,01,00,11,14,01,11,02,01,02,15,03,04,11,13,03,05,10,03,03,02,04,00,11,00,12,10,13,13
04,15,11,11,13,04,05,12,12,05,15,03,02,12,10,04,10,01,04,10,15,10,10,42,13,10,12,04,04,02,02,05
13,13,04,10,02,12,04,15,00,01,14,04,02,00,15,12,05,10,13,03,01,11,15,14,15,04,01,14,14,01,15,05
14,15,02,10,14,00,05,03,03,05,00,01,05,02,13,13,10,04,02,13,03,03,14,10,05,03,14,01,00,00,15,00
05,03,14,11,03,05,10,10,11,15,01,01,42,13,00,13,15,10,05,10,00,14,12,00,14,02,12,01,03,14,12,04
11,04,10,12,10,02,15,10,14,00,10,01,42,14,03,13,03,14,15,04,14,10,04,04,02,13,01,02,00,02,12,03
04,01,01,01,11,12,11,11,02,02,12,10,03,12,05,42,15,03,15,04,02,15,00,02,00,10,10,04,10,11,12,03
14,14,15,04,03,12,14,00,11,15,12,05,00,01,13,10,11,15,10,11,04,13,14,05,04,14,02,02,01,11,04,11
00,11,12,15,03,14,05,00,04,13,14,11,13,11,13,15,03,13,11,13,10,13,00,04,12,03,10,10,14,11,00,14
11,00,03,10,15,13,01,15,10,00,00,11,00,10,12,02,13,04,04,12,15,12,10,00,04,04,05,12,15,02,15,11
12,11,03,10,00,11,00,10,11,05,02,14,11,10,14,02,12,12,13,15,04,04,03,05,04,12,01,01,42,10,00,04
02,00,12,13,15,14,03,05,05,11,13,04,10,12,04,10,00,02,04,02,42,13,00,01,01,00,03,11,12,02,10,10
14,13,13,15,14,15,01,10,00,13,05,03,03,03,01,14,03,11,15,04,42,11,10,00,04,10,00,00,01,10,12,12
13,03,10,14,02,05,13,03,00,00,15,03,15,11,10,10,12,15,03,03,03,12,14,13,12,05,12,15,12,05,12,14
05,03,04,01,00,15,15,10,01,01,10,01,04,02,01,05,02,12,03,05,00,11,03,00,14,00,05,00,01,04,05,13
14,13,03,04,01,00,11,42,42,15,04,04,05,04,11,01,01,01,02,13,12,03,13,02,11,03,13,01,05,05,01,13
14,15,05,14,05,03,02,13,05,14,10,05,10,02,02,03,02,14,00,00,03,15,11,03,02,13,01,01,14,10,03,13
02,12,15,14,00,10,10,12,05,04,03,15,01,12,15,02,03,15,03,11,05,12,04,11,01,03,15,05,12,11,00,15
10,02,12,02,03,01,12,00,14,05,04,12,05,04,12,03,12,15,03,01,03,15,01,14,12,00,01,14,12,11,15,05
00,05,00,00,12,13,03,03,04,05,15,03,15,05,15,00,04,01,05,14,42,05,15,10,02,15,13,03,11,03,10,11
03,11,11,13,05,01,14,01,00,15,15,00,13,02,10,15,00,03,15,13,14,03,10,10,12,10,01,15,05,11,04,13
05,10,12,03,13,01,11,12,00,15,00,01,11,10,04,14,04,13,01,01,01,01,01,01,01,01,01,01,01,01,01,01
10,15,01,01,15,10,02,02,00,13,05,01,01,00,00,13,05,04,11,13,00,05,10,10,04,03,14,05,13,04,05,13
00,12,14,05,13,00,04,02,14,05,10,00,12,02,13,05,14,13,02,02,03,14,05,00,01,11,14,03,11,02,15,10

210,223,223,223,223,223,223,223,223,223,223,223,223,223,223,223,223,223,223,223,223,223,223,223,223,223,223,223,223,223,223,230
201,000,000,000,000,000,000,000,000,000,000,000,000,000,000,000,000,000,000,000,000,000,000,000,000,000,000,000,000,000,000,201
201,000,000,000,000,000,000,000,000,000,000,000,000,000,000,000,000,000,000,000,000,000,000,000,000,000,000,181,000,000,000,201
201,000,000,000,000,000,000,000,000,000,000,000,000,000,000,000,000,000,000,000,000,000,000,000,000,000,000,000,000,000,000,201
201,000,000,000,000,000,000,000,000,000,000,000,000,000,000,000,000,000,000,000,000,000,000,000,000,000,000,000,000,000,000,201
201,000,000,000,000,104,114,000,000,000,000,000,000,000,000,000,000,000,000,000,000,000,000,000,000,000,000,000,000,000,000,201
201,000,000,000,000,000,000,000,000,000,000,000,000,000,000,000,000,000,000,000,000,000,000,000,000,000,000,000,000,000,000,201
201,000,000,000,000,000,000,000,000,000,000,000,000,000,000,000,181,000,000,000,000,000,000,000,000,000,000,000,000,000,000,201
201,000,000,000,000,000,000,000,000,000,000,000,000,000,000,000,000,000,000,000,000,000,000,000,000,000,000,000,000,000,000,201
201,000,000,000,000,000,000,000,000,000,000,000,000,000,000,000,000,000,000,000,000,000,000,000,000,000,000,000,000,000,000,201
201,000,000,000,000,000,000,000,000,000,000,000,000,000,000,000,000,000,000,000,000,000,000,000,000,000,000,000,000,000,000,201
201,000,000,000,000,000,000,000,000,000,000,000,000,000,000,000,000,000,000,000,000,000,000,000,000,000,000,000,000,000,000,201
201,000,000,000,000,000,000,000,000,000,000,000,000,000,000,000,000,000,000,000,000,000,000,000,000,000,000,000,000,000,000,201
201,000,000,000,000,000,000,000,000,000,000,000,000,000,000,000,000,000,000,000,000,000,000,104,114,000,000,000,000,000,000,201
201,000,000,000,000,000,000,000,000,000,000,000,000,000,300,310,320,000,000,000,000,000,000,000,000,000,000,000,000,000,000,201
201,000,000,000,000,181,000,000,000,000,000,000,000,000,301,311,321,000,000,000,000,000,000,000,000,000,000,000,000,000,000,201
201,000,000,000,000,000,000,000,000,000,000,000,000,000,302,312,322,000,000,000,000,000,000,000,000,000,000,000,000,000,000,201
201,000,000,000,000,000,000,000,000,000,000,000,000,000,000,000,000,000,000,000,000,000,000,000,000,000,000,000,000,000,000,201
201,000,000,000,000,000,000,000,000,000,000,000,000,000,000,000,000,000,000,000,000,000,000,000,000,000,000,000,000,000,000,201
201,000,000,000,000,000,000,000,000,000,000,000,000,000,000,000,000,000,000,000,000,000,000,000,000,000,000,000,000,000,000,201
201,000,000,000,000,000,000,000,000,000,000,000,000,000,000,000,000,000,000,000,000,000,000,000,000,000,000,000,000,000,000,201
201,000,000,000,000,000,000,000,000,000,000,000,000,000,000,000,000,000,000,000,000,000,000,000,000,181,000,000,000,000,000,201
201,000,000,000,000,000,000,000,000,000,000,000,000,000,000,000,000,000,000,000,000,000,000,000,000,000,000,000,000,000,000,201
201,000,000,000,000,000,000,000,000,000,000,000,000,000,000,000,000,000,000,000,000,000,000,000,000,000,000,000,000,000,000,201
201,000,000,000,000,000,000,000,000,000,000,104,114,000,000,000,000,000,000,000,000,000,000,000,000,000,000,000,000,000,000,201
201,000,000,000,000,000,000,000,000,000,000,000,000,000,000,000,000,000,000,000,000,000,000,000,000,000,000,000,000,000,000,201
201,000,000,000,000,000,000,000,000,000,000,000,000,000,000,000,000,000,000,000,000,000,000,000,000,000,000,000,000,000,000,201
201,000,000,000,000,000,000,000,000,000,000,000,000,000,000,000,000,000,000,000,000,000,181,000,000,000,000,000,000,000,000,201
201,000,000,000,000,000,000,000,000,000,000,000,000,000,000,000,000,000,000,000,000,000,000,000,000,000,000,000,000,000,000,201
201,000,000,000,000,000,000,000,000,000,000,000,000,000,000,000,000,000,000,000,000,000,000,000,000,000,000,000,000,000,000,201
201,000,000,000,000,000,000,000,000,000,000,000,000,000,000,000,000,000,000,000,000,000,000,000,000,000,000,000,000,000,000,201
212,223,223,223,223,223,223,223,223,223,223,223,223,223,223,223,223,223,223,223,223,223,223,223,223,223,223,223,223,223,223,232